                   J    
                        
  PPPPPPPPPPPPPPPPP   P 
   PV P         M P   P 
   P  P PPPPPPPP  P   P 
   PM P  P M   P  P   P 
      P     P  P  P   P 
  PPPPPPPP  P  P MP   P 
  PV  M     P  P  P   P 
  PPPPPPPP        P   P 
      P     PPPPPPP   P 
  PPPPP  PPPP         P 
  P   P          M    P 
  P   PPPPPPPPPPPPPPPPP 
  P                     
  P                     