           V            
                        
    PPPPPPPPPPPPPPP     
 M  P             P  M  
    P       P     P     
    P             P     
    P     J       P     
 M  P             P  M  
    P P           P     
    P             P     
    P         P   P     
 M  P             P  M  
    PPPPPP   PPPPPP     
                        
   B              B     
                        