                   J    
                        
  PPPPPPPPPPPPPPPPP   P 
   P  P           P   P 
   P  P PPPPPPPP  P   P 
   P  P  P M   P  P   P 
      P     P  P  P   P 
  PPPPPPPP  P  P  P   P 
  P         P  P  P   P 
  PPPPPPPP        P   P 
      P     PPPPPPP   P 
  PPPPP  PPPP         P 
  P   P               P 
  P   PPPPPPPPPPPPPPPPP 
  P                     
  P                     